##########
#        #
#        #
#    o   #
#        #
#  X     #
#       .#
#        #
#        #
##########